1111111111111111111111111111111111111111
1P0000000000000C00000000000C00000000C001
1001111111101111111101111111101111111101
10000000M0100100000010000001010000000101
1001000000100100000010000001010000000101
1001111111100111111101111110011111111101
10000C0000000000000000000M000000000C0001
1011111111111111111100111111111111111101
1000000000000000M0000000000000000000M001
1011111110111111111110110111111110111101
10100000000000C00000001C1000C0001010C001
1010000000100000000000101000000010100001
1011111110111111111111001111111011111101
100000000000000000000000000M000000000001
1011110111110111111111111110111111111101
10100000C00010M000000000000010000000C001
1010000000001000000000000000100000000101
1011111111111111111111111110111111111101
100000000000000000000000000000000M000001
101110010100101001101111011100101001E101
1111111111111111111111111111111111111111