11111111111111111111
1P0C00000000000C0001
10111111110111111101
100M0000010000M00001
101111100101111110C1
10000010010100000101
1C111M10010101111101
101000100101000C0001
101011100101011111M1
10000000000000000001
1C000111111111000E01
11111111111111111111
