1111111111111111111111111111111111111111
1P000000000000000000000000000000000000C1
1000111111111000000011111111100000111111
10001C0000001000C0001000000010M000100001
1000100000001000000010000000100000100001
10001000M0001111111110000000111111100001
1000100000000000000000000000000000000001
1000111111111111111111111111111111111101
1000000000000000000000000000000000000001
1011111111111000000000001111111111111101
1000000000001000C00000001000000000000001
1000000000001000000000001000000000000001
1000000M00001111111111111000000M00000001
10C0000000000000000000000000000000000001
1000000000000000000000000000000000000001
1011111111111111111111111111000000111101
10000000000000000000000000E1000000100001
1000000000C0000000000M00000100000010M001
10000000000000000000000000010000000000C1
1000000000000M00000000000001010010100001
1111111111111111111111111111111111111111