1111111
1P0C001
100M001
10CCC01
100M001
100E001
1111111
