111111111111111111
1P000000000000C001
10111M1111111110C1
100000000C00000001
1111011111011111M1
10C0000000000000C1
101111M111111011C1
100000010000000001
101110M101111111C1
100000000100000001
11111101011111C101
1000000000000000C1
10111111111111M101
10C00000000000C0E1
111111111111111111
