111111111111111111111
1P00000100000000000C1
101111101011111011101
1C0000M00100001000001
101111111010101111101
1000000000001010000M1
101111111111101011101
1000000000C0000000001
101111101111111011101
100000101000001000001
11111010101E101011111
1000000010000010000C1
101111111011111111101
100000000010000000001
101111101110111110101
1M0000100000000001001
101111101111111011101
1C00000000000000000M1
111111111111111111111