1111111111111111111111111
1P0C0000000M00000000C0001
10111011101110111011101E1
10000M00000000000M000C001
101110111011101110111C101
1C00000000M0000000000C001
10111011101110111011101C1
1111111111111111111111111
