111111111111111
1P00000001C0001
1011111001110E1
10C00M0000000C1
1011110111111M1
100000010000001
101111M10111101
10C000000C00001
101111111111101
111111111111111
